R 5000 3000
NO                ./srcs/textures/BRICK4.xpm 
SO        ./srcs/textures/BSTONE1.xpm
WE ./srcs/textures/BRICK7.xpm
EA ./srcs/textures/BRICKLIT.xpm

S                             ./srcs/textures/barrel.xpm
F        ./srcs/textures/wall.xpm 
C  ./srcs/textures/wall.xpm 

11111111111
101010101011
1200000000021
101001001011
10100100001
10000000001
10000000001
100N0000021
11111111111