R 1920 1080
NO                ./north_texture
SO        ./sud_texture
WE ./wesh_texture
EA ./east_texture

S ./sprite_texture
F 220,100       ,         0
C 225,30,0

1111111
1010101
1000001
1000001
1000001
100N001
1111111