R 1920 1080
NO                ./textures/BRICK4.xpm
SO        BSTONE1.xpm
WE BRICK7.xpm
EA BRICKLIT.xpm

S ./sprite_texture
F 220,100       ,         0
C 225,30,0

11111111111
10101011111
10000000001
10110011101
10100011001
100N0000001
11111111111