R 1920 1080 
NO                ./srcs/textures/BRICK4.xpm 
SO        ./srcs/textures/BSTONE1.xpm
WE ./srcs/textures/BRICK7.xpm
EA ./srcs/textures/BRICKLIT.xpm

S ./srcs/textures/wall.xpm 
F 220,100       ,         0
C 225,30,0

11111111111
10101010101
10000000001
10100100101
10100100001
100N0000001
11111111111