R 2560 1440 
NO                ./srcs/textures/BRICK4.xpm 
SO        ./srcs/textures/BSTONE1.xpm
WE ./srcs/textures/BRICK7.xpm
EA ./srcs/textures/BRICKLIT.xpm

S                             ./srcs/textures/barrel.xpm
F        ./srcs/textures/wall.xpm 
C  ./srcs/textures/wall.xpm 

11111111111
101010101011
1200000000021
101001001011
10100100001
100N0000001
11111111111